111111111111
1P00000000E1
111111111111