11111
1P0C1
10001
1C0E1
11111

