111111
1P0001
101C011
1000E1
111111