11111
1P001
100X1
1CEC1
11111
