11111
1P001
10011
1CEC1
11111
