111111
1P0001
101E011
1000C1
111111