111111111
1P0000001
101111110
1000000E1
111111111