11111111111111111111
1P000C00000000C00001
10111000000000000001
1C0000000C0001110001
10000000000001E10001
10000000000000000001
100000C000C000000001
10000000000000000001
10000000000000000001
10000000000000000001
1000C000000000000001
1000000C0000000C0001
11111111111111111111
