111111
1P0001
100001
10C101
101E01
111111